0000000000000000000000000000000000000000
0000000000000000000000000000000000000000
0000000000000000000000000000000000000000
0000000000000000000000000000000000000000
0000000000000000000000000000000000000000
0000000000000000001859111112000000000000
0000000000000000000080818200000000000000
000043040d000000000080818200000000000000
00000000000000000000909192000000000b490d
00000000000000000000a0a1a200004b0149020d
0b0c044c04444c0c444444044c0c0c0c04440405

image image:tiles
sprite @3,9 (u16:spritetype)hero
sprite @3,6 (u16:spritetype)pumpkin
sprite @9,4 (u16:spritetype)balloon
sprite @11,4 (u16:spritetype)bomb
sprite @13,4 (u16:spritetype)hippopotamus
