000000000000000d000000000000000000000000
000000000000000d000000000000000000000000
4b0c4c4c0d00000d000000000000000000000000
000000000000000d000000000000000000000000
000000000000000d000006000000000000000000
000000000000000b451019115112000000000000
0000000000000000000080818213000000000000
0000430d00000000000080818213000000000000
000000000000000000009091921300000000030d
00000000000000000000a0a1a21300000b41090d
0b0c044c04444c0c44444404440c4c4c4c440405

image image:tiles
sprite @3,9 (u16:spritetype)hero
sprite @3,6 (u16:spritetype)pumpkin
sprite @9,4 (u16:spritetype)balloon
sprite @11,4 (u16:spritetype)bomb
sprite @13,4 (u16:spritetype)hippopotamus
