0000000000000000000000000000000000000000
0000000000000000000000000000000000000000
0000000000000000000000000000000000000000
0000000000000000000000000000000000000000
0000000000000000000000000000000000000000
0000000000000000001859111112000000000000
0000000000000000000080818200000000000000
000043040d000000000080818200000000000000
0000000000000000000090919200000000000000
00000000000000000000a0a1a200000000000000
0b0c044c04444c0c444444044c0c4c04444c440d

image image:tiles
