0000000000000004000000000000000000000000
0000000000000004000000000000000000000000
0304040405000004000000000000000000000000
0000000000000004000000000000000000000000
0000000000000004000006000000000000000000
0000000000000003055819115112000000000000
0000000000000000000080818213000000000000
0000030500000000000080818213000000000000
0000000000838400000090919213000000000305
00000000000707000000a0a1a213000003010105
0304040404040404040404040404040404040405

image image:tiles
sprite @3,9 (u16:spritetype)hero
sprite @3,6 (u16:spritetype)pumpkin
sprite @9,4 (u16:spritetype)balloon
sprite @11,4 (u16:spritetype)bomb
sprite @13,4 (u16:spritetype)hippopotamus
sprite @8,9 (u16:spritetype)fire
