0303030435353535060303030303030303030303
0303031783848586170303030303030303030303
0303031793949596143535353535353535353506
0435352535353535260000000013000000000017
1780818200000000000000000013000000000017
1790919200000000000000000013000001000017
17a0a1a200000000202122230436101111111227
1435353536000000020000021703030303030303
1700000000000000043535352603030303030303
1700000000000000170303030303030303030303
2435353535353535260303030303030303030303

image image:tiles
sprite @2,9 (u16:spritetype)hero
sprite @7,9 (u16:spritetype)pumpkin
sprite @5,9 (u16:spritetype)pumpkin
sprite @6,9 (u16:spritetype)pumpkin
