0303030303030303030303030303030303030303
0435353535353535353535353535353535353506
1700000000000000000000000000000080818217
1700000000000000000000000000000090919217
17000000000000000000000000000007a0a1a217
1700000000343535353535353535352535353516
1700000000001300001300001300000000000017
2435060000001300001300001300000000000017
0303170000001300001300001300000000010017
0303243535353535353535353535353610111227
0303030303030303030303030303030303030303

image image:2
sprite @17,4 (u16:spritetype)hero
sprite @6,4 (u16:spritetype)pumpkin
sprite @9,4 (u16:spritetype)pumpkin
sprite @12,4 (u16:spritetype)pumpkin
