0000000000000000000000000000000000000000
0000000000000000000000000000000000000000
0000000000000000000000000000000000000000
0000000000000000000000000058111a00000000
0000000000000000000000000000000000000000
0000000000000304050000000000000000000000
0000000000000000000000000000000003040405
0304050000000000000000000000000000808182
0000000000000000000000000000000000909192
0000000000000000000000000000000305a0a1a2
0304040404040404040404040404040404040405

image image:2
sprite @7,9 (u16:spritetype)hero
sprite @17,5 (u16:spritetype)pumpkin
sprite @18,5 (u16:spritetype)pumpkin
