0000000000000000000000000000000000000000
0000000000000000000000000000000000000000
0000000000000000000000000000000000000000
0000000000000000000000000058111a00000000
0000000000000000000000000000000000000000
0000000000003435360000000000000000000000
0000000000000000000000000000000034353536
3435360000000000000000000000000000808182
0000000000000000000000000000000000909192
0000000000000000000000000000000406a0a1a2
3435353535353535353535353535352525353536

image image:2
sprite @7,9 (u16:spritetype)hero
sprite @17,5 (u16:spritetype)pumpkin
sprite @18,5 (u16:spritetype)pumpkin
sprite @11,9 (u16:spritetype)fire
