0000000000000000000007000000000000000000
0000000000000000000017000000000000000000
0000000000000034353526000000000100000000
00000000000000000030000000181919191a0000
0000000000000000003000000000000000000000
0000000000003435353506000000000000000000
0032000000000000000024353535353535353536
3435360000000000000000000000000000808182
0000000000000000000000000000000000909192
0000000000000000000000000000000007a0a1a2
3435353535353535353535353535353525353536

image image:2
sprite @18,9 (u16:spritetype)hero
sprite @4,9 (u16:spritetype)pumpkin
sprite @6,9 (u16:spritetype)pumpkin
treadle @1,6 1 0
lock @9,4 1 0
lock @9,3 1 0
