0700000000000000000007030303030303030303
1700000000000000000017030303030303030303
1700000000043506000017030303030303030303
1700000000170317000024353535353535353506
1700000000170317000000000000000000000017
1700003435160317000000000000320000000017
1700000000243525353535353535353535353516
1700000000000000000000808182300000000017
2435060000000000000000909192300000010017
0303170000000000000000a0a1a2301011111217
0303243535353535353535353535353535353526

image image:2
sprite @12,9 (u16:spritetype)hero
sprite @9,3 (u16:spritetype)fire
sprite @8,9 (u16:spritetype)pumpkin
sprite @4,9 (u16:spritetype)pumpkin
sprite @6,9 (u16:spritetype)pumpkin
sprite @8,3 (u16:spritetype)fire
treadle @14,5 1 0
lock @14,9 1 0
lock @14,7 1 0
lock @14,8 1 0
