0303030303030303030303030303030303030303
0303030303030303030303030303030303030303
0304353535353535353535060303030303030303
0317808182000000000000243535353535060303
0317909192000000000000300030000000170303
0317a0a1a2000000000000300030000000170303
0324353506000032000000043506313131170303
0303030317000004360000170317101112170303
0303030324353526030303170324353535260303
0303030303030303030303270303030303030303
0303030303030303030303030303030303030303

image image:2
sprite @3,5 (u16:spritetype)hero
sprite @8,6 (u16:spritetype)pumpkin
treadle @7,6 1 0
lock @13,5 1 0
lock @16,6 1 1
lock @11,4 1 0
lock @11,5 1 0
lock @13,4 1 0
lock @14,6 1 1
lock @15,6 1 1
