0700000000000000000000000000000000070303
1700000000000000000000000000000000170303
1700000000000000000000000000000000170303
1700000004353535353535353535060000170303
1700000017808182000000000000170000170303
1700000017909192000000000000170000170303
1700000017a0a1a2000007303030170000170303
1700000024353536000017000000170000243506
1700000000000000000017000100170013000017
1700000000000000000017101112170013003217
2435353535353535353525353535253535353526

image image:2
sprite @6,6 (u16:spritetype)hero
treadle @18,9 1 0
lock @13,6 1 0
sprite @7,9 (u16:spritetype)pumpkin
sprite @3,9 (u16:spritetype)pumpkin
sprite @5,9 (u16:spritetype)pumpkin
lock @12,6 1 0
lock @11,6 1 0
