0435353535353505353535353535353535353506
1700000000000017000000000000000000000017
1435353506000017000000000000000000000017
1780818217000017000000000000000000000017
1790919217000027000004353535353536000017
17a0a1a217000000000017000000000000000017
1730303017000000000017000000000000000017
1710111224353535353526000000000000000017
1700000000000000000000000000000000000017
1700320000000000000000000007000000000017
2435353535353535353535353525353535353526

image image:2
sprite @5,4 (u16:spritetype)fire
sprite @6,4 (u16:spritetype)fire
sprite @2,1 (u16:spritetype)pumpkin
sprite @2,5 (u16:spritetype)hero
treadle @2,9 1 0
lock @3,6 1 0
lock @1,6 1 0
lock @2,6 1 0
